NO ./textures/WALL1.xpm
SO ./textures/WALL2.xpm
WE ./textures/WALL3.xpm
EA ./textures/WALL4.xpm

F 220,100,0
C 225,30,0

11111111
10000001
100W0001
10000001
11111111