NO ./textures/WALL1.xpm
SO ./textures/WALL3.xpm


F 0,0,0
WE ./textures/WALL2.xpm
C    255,255,255

EA ./textures/WALL4.xpm
111111111111111111111111111111
10000000000000000000000000001
11111111111110000000000000001
11111111111110000000000000001
10000000000000000000000000001
10000000000000000000000000001
11111111111111111111111111111
11111111111111111111111111111
10000000000000000000000000001
100000000000000000000000000S1
10000000000000000000000000001
10000000000000000000000000001
10000100000000000000000000001
10000100000010000000000000001
10000000000000000000000000001
11111111111111111111111111111