F     220,100,0

NO ./textures/WALL1.xpm


SO    ./textures/WALL2.xpm
WE ./textures/WALL3.xpm




EA                 ./textures/WALL4.xpm
C 225,30,0

        1111111111111111111111111
        1000000001 10000000000001
        1000000001110000000000001
        1001000000000000000000001
111111111001000000000000000000001
110000000001000001000111111111111
11000111111111011100000010001
11000111111111011100000010001
11000000110101011100000000001
10000000000000001100000000001
10000000000000001100000000001
10010001110000011100001000N01
10000001 1100001 100111000001
11111111 1111111 111111111111


