

NO ./textures/WALL1.xpm

SO    ./textures/WALL2.xpm
WE ./textures/WALL1.xpm




EA                 ./textures/WALL1.xpm
C                                0,0,214
F     215,0,0

        1111111111111111111111111
        1000000001 11111000000001
        1000000001110000000000001
        1001000000000000000000001
111111111001000000000000000000001
110000000001000001000111111111111
11000111111111011100000010001                     
11000111111111011100000010001
11000000110101011100000000001
10000000000000001100000000001
10000000000000001100000000001
100100011100000111000010N0001
10000001 1100001 100111000001
11111111 1111111 111111111111


