F     220,100,0

NO ./textures/WALL1.xpm


SO    ./textures/WALL2.xpm
WE ./textures/WALL3.xpm




EA                 ./textures/WALL4.xpm
C 225,30,0

        1111111111111111111111111
        1000000001 10000000000001
        1011000001110000000000001
        1001000000000000000000001
111111111011000001110000000000001
100000000011000001110111111111111
11110111111111011100000010001
11110111111111011101010010001
11000000110101011100000010001
10000000000000001100000000001
10000000000000001101010010001
10010001110101011111011110N0111
10000001 1110101 101111010001
11111111 1111111 111111111111


